####################
#.................@#
#..ggggggg.........#
#....oo............#
#........$$$$$$$$..#
#..................#
#.##################
#..................#
#........o.........#
#..g...............#
#..................#
#..........g.......#
#..................#
##################.#
#..................#
#..........$....o..#
#..................#
#...o..............#
#.<.oo.............#
#...o..............#
####################
