####################
#..................#
#..g...............#
#..................#
#..................#
#..................#
#.##################
#..................#
#........o.........#
#..g...............#
#..................#
#..........g.......#
#..................#
##################@#
#..................#
#..........$....o..#
#..................#
#...o..............#
#.<.oo.............#
#...o..............#
####################
